1111111
11011E1
1P000C1
1111110
