1111111111111
1E10101C00C11
1010000001001
10C10P0010C01
1001001000001
1000001C00001
11000000C0C01
1111111111111
