1111111111
1001010111
1P00C000E1
100C000001
1111111111
